16,8
0, 0, DH,0, 0, 0, 0, 0, 0, 0, 0, 0, 0, 0, 0, 0
0, _, S, _, 0, 0, 0, 0, 0, 0, 0, 0, 0, 0, 0, 0
0, _, _, _, 0, 0, 0, 0, 0, 0, 0, R0,0, 0, 0, 0
0, _, _, _, _, _, _, _, _, _, _, _, _, K, 0, 0
0, _, _, _, _, _, _, _, _, _, _, _, _, 0, 0, 0
0, _, _, _, _, _, _, 0, E0,0, 0, _, _, 0, 0, 0
E0,_, _, _, _, _, _, 0, 0, 0, 0, _, _, R0,0, 0
0, 0, 0, 0, 0, 0, 0, 0, 0, 0, 0, 0, 0, 0, 0, 0