11,15
0, 0, 0, 0, R1,0, 0, 0, R2,0, 0
0, 0, 0, _, _, _, _, _, _, _, 0
0, 0, e1,_, _, _, _, _, _, _, 0
0, 0, 0, _, _, _, _, /, _, _, 0
0, 0, 0, _, _, _, _, _, _, _, 0
0, 0, E1,_, _, _, 0, 0, 0, 0, 0
0, 0, 0, _, _, _, 0, 0, 0, 0, 0
0, 0, 0, _, _z,_, 0, 0, 0, 0, 0
0, 0, 0, _, _, _, 0, 0, 0, 0, 0
0, 0, E0,_, _, _, 0, 0, 0, 0, 0
0, 0, 0, _, _, _, 0, 0, 0, 0, 0
0, 0, 0, _, _, _, _, _, _, _, 0
0, K, d2,_, _, _, /, _, _, S, DH
0, 0, 0, _, _, _, _, _, _, _, 0
0, 0, 0, 0, 0, 0, 0, 0, 0, 0, 0