16,9
0, 0, 0, 0, 0, 0, 0, 0, 0, 0, 0, 0, 0, 0, 0, 0
0, 0, 0, 0, 0, 0, 0, 0, 0, 0, 0, 0, 0, 0, 0, 0
0, _, S, _, 0, 0, 0, 0, 0, 0, 0, 0, 0, 0, 0, 0
0, _, _, _, 0, 0, 0, 0, 0, 0, 0, R, 0, 0, 0, 0
0, _, _, _, _, _, _, _, _, _, _, _, _, K, 0, 0
0, _, _, _, _, _, _, _, _, _, _, _, _, 0, 0, 0
0, _, _, _, _, _, _, 0, E, 0, 0, _, _, 0, 0, 0
E, _, _, _, _, _, _, 0, 0, 0, 0, _, _, R, 0, 0
0, 0, 0, 0, 0, 0, 0, 0, 0, 0, 0, 0, 0, 0, 0, 0